.o....o.
..o....o
ooo..ooo
........
........
.o......
..o.....
ooo.....
........
........
.o......
..o.....
ooo.....